컨셉 기획의 포인트

1. 정의 : 기획의도, 필요한이유, 용어 등을 정하는 과정
2. 설정 : 규칙, 절차 등을 정하는 것
3. 방향 : 해당 컨텐츠의 방향성, 해당 컨텐츠가 불러올 변화
4. 요소 : 필요한 요소


기획의도를 읽는 습관을 기르자


제목 : 제목
개요 : 간단하게
기획의도 : 설계하게된 기획자 자체의 과정 or 의도
목표 : 기획의도와 구분되는 구현하고자 하는 명확한 목표
구현필요성 : 기존의 문제점들, 기획이 필요한 구체적인 근거
마인드맵 or 표
세부내용 : 시스템기획에 필요한 세부사항 
애니메이션 : 동작별 프레임이나 동작컨셉과 연출핵심사항
예상효과 : 약파는구간



자기결정이론
내재적 동기 : 자연적으로 나타나며 자기만족을 위해 플레이어 스스로 발생시키는 동기(추가보상 필요X)
외재적 동기 : 외부적 요인에 따라(강요, 필요) 발생되는 동기

개인 스스로 욕구를 행동화하고 선택하면 심리적 안정감을 가지게 된다

전경(figure) : 매체가 감각정으로 부각되는 방식 - 가운데 위치한 것, 집중해야 하는것
배경(ground) : 전경을 그러내는 방법과 토대를 제공하는 방식 - 주변에 깔리는 것, 집중을 방해함

전경에만 집중되면 게임의 난이도가 떨어지고 쉽게 질리게됨



프레이밍 효과
동일한 정보를 두고 제시하는 표현방식에 따라 전혀 상반된 의사결정이 이루어짐

불안회피경향 : 긍정적인 표현이 중심일때, 불확실한 선택지를 피함, 부정적인 표현이 중심일 때는 불확실한 표현을 선호
미리 뺐어놓고 보상으로 주는 척


행동주의에 입각한 조작적 조건화
정적강화 : 좋아하는 자극을 준다 > 특정행동의 빈도 증가
부적강화 : 싫어하는 자극을 제거 > 특정행동의 빈도 증가
정적처벌 : 싫어하는 자극을 준다 > 특정행동의 빈도 감소     
부적처벌 : 좋아하는 자극을 제거 > 특정행동의 빈도 감소

강화는 플레이 초반에는 부적강화가 가장 효과가 크지만 지속성이 모자람(요소를 제거하는데는 한계가 있음)
정적강화는 한계가 없기 때문에 장기적으로 정적강화를 사용하는 형태로 변화해야 함(데이터라는 특성)

처벌은 정적처벌이 간단하고 효과가 좋으나 그러나 유저의 스트레스가 심함


강화스케줄 - 어떤 스케줄에 맞춰 강화를 제공한것인가
연속적강화 : 특정행동이 발생할 때마다 계속 주는것
간헐적강화 : 특정행동이 발생해도 드물게 주는것

완정정보 : 다 암
불완전정보 : 누군가는 모름

어드벤처게임
불완전 정보 -> 완전 정보 (정보가 쌓여서 완성되어가는 과정이 모험의 재미를 배가시킴)